#################
        #       #
# ##### # ##### #
#   # # #     # #
# # # # ##### # #
#   # #       # # 
### # ####### # #
#   # #    #  # # 
# ### # ## # ##  
#     # ##    #  
#################