##############################
# #       # #   #             
# ####### # ### # # ##### # # 
#   E             # #   # # # 
### # ##### # ### # # ##### # 
#   # #     # #   #       # #S
### ##### ### ### # ####### ##
# # # #   #   #   #       #   
# ### # # ### # # # # ####### 
#       # # # # # # #       # 
# ### ### # ### ##### # # ####
# # # #       # #   # # #     
### ### # # # ### ### # ### ##
#       # # #       # #   #   
##############################
