 #   #   #     #   #     #   #
 ### # ### ####### ##### # ###
 # # # #   # #   #   # #     #
 # # # # ### # ### ### # ### #
   #   #     # #         # # #
## ### ### ### ### ####### ###
   # # #     # #     # # #   #
## # # ### ### ### ### # # ###
       # #           #     # #
###### # ##### ######### ### #
 #         #   # #   #   # # #
S##### ### # # # # ### ### # #
 #   # #  E  #   # #         #
 ### ### ##### ### ### # #####
 #     #   #     # #   # # # #
 ### ######### # # # # # # # #
     #   #   # #     # #     #
#### ### # ##### ######### # #
             #     #     # # #
 ### # # ####### ### #########
 #   # #   #       #       # #
######## ### # ### ### ##### #
 # # #       # # #       # # #
 # # # # ### ### # # ##### # #
     # # #       # #         #
#### ####### ##### # # ### # #
               #   # #   # # #
 # # # # # # # # # # # ### # #
 # # # # # # # # # # #   # # #
##############################